

    +---+                               +---+                               +---+
    |   |-------------------------------|   |-------------------------------|   |
    +---+                               +---+                               +---+
      |                                   |                                   |  
      |                                   |                                   |  
      |                                   |                                   |  
      |         +---+                   +---+                   +---+         |  
      |         |   |-------------------|   |-------------------|   |         |  
      |         +---+                   +---+                   +---+         |  
      |           |                       |                       |           |  
      |           |                       |                       |           |  
      |           |                       |                       |           |  
      |           |         +---+       +---+       +---+         |           |  
      |           |         |   |-------|   |-------|   |         |           |  
      |           |         +---+       +---+       +---+         |           |  
      |           |           |                       |           |           |  
      |           |           |                       |           |           |  
      |           |           |                       |           |           |  
    +---+       +---+       +---+                   +---+       +---+       +---+
    |   |-------|   |-------|   |                   |   |-------|   |-------|   |
    +---+       +---+       +---+                   +---+       +---+       +---+
      |           |           |                       |           |           |  
      |           |           |                       |           |           |  
      |           |           |                       |           |           |  
      |           |         +---+       +---+       +---+         |           |  
      |           |         |   |-------|   |-------|   |         |           |  
      |           |         +---+       +---+       +---+         |           |  
      |           |                       |                       |           |  
      |           |                       |                       |           |  
      |           |                       |                       |           |  
      |         +---+                   +---+                   +---+         |  
      |         |   |-------------------|   |-------------------|   |         |  
      |         +---+                   +---+                   +---+         |  
      |                                   |                                   |  
      |                                   |                                   |  
      |                                   |                                   |  
    +---+                               +---+                               +---+
    |   |-------------------------------|   |-------------------------------|   |
    +---+                               +---+                               +---+
+--   --+
|       |
         
|       |
+--   --+
+   |   +
    |    
---   ---
    |    
+   |   +
+-----------------------------+
|  +-----------------------+  |
|  |                       |  |
|  +-----------------------+  |
|                             |
|                             |
|                             |
|                             |
|                             |
|                             |
|                             |
|                             |
|                             |
|                             |
|                             |
|                             |
|                             |
+-----------------------------+
+---+
|   |
+---+